    ,;;;;:::::;I
  ,;;;;;;;;:;JII
  MM8888888|YJJI
  MMM888888|YYJI
  MMMMM8888|YYY'
  MMMMMMMM8|YY' 
  MMMMMMMMM|Y'  
