   ________0_/_______   
 ,/----          ----\, 
/    8     = =         \
|  88888           {A} |
\    8   ______ {B}    /
 -\_____/      \_____/- 
