   ________0_/_______   
 ,/----          ----\, 
/     8   = =          \
|   88888      {B} {A} |
\     8    __          /
 -\_______/ -\_______/- 
