 ,_______,
_|,_____,|
=||A0123||
=||O0O00||
-|'-----'|
 '-------'
