================
|              |
|   < HTML >   |
|              |
================
     |    |     
